a_e_a_e_a_
_f_b_f_b_f
a_h_a_h_a_
_e_b_e_b_e
c_f_c_f_c_
_h_d_h_d_h
__g____g__